111111111111111111111111111111111111
1E10000000000C000000z0000C0000000001
101010111011101011111X1X1X1X1X1X1X01
1000000000001000000000000000C0000001
110010000000110000000000000000000001
101010101000110101011111100011101011
1000000011C11100000100z0000000000011
1P00000011000000000000000000X0000001
111111111111111111111111111111111111