1111111111111111111111111111111111
1h0000000000000C0P000C00j0000000E1
101001010010000010100100PP00010101
1010010010101010001001000000010101
100000000C00C0000000000j0h00000001
1111111111111111111111111111111111