1111111111111111111111111111111111
1h00000000X0000C000P0C00j0000000E1
1010010100100000101001000000010101
1010010010101010001001000000010101
100000000C00C0000020000j0h00X00001
1111111111111111111111111111111111