1111111111111111111111
10000000P10000001p1101
1001000000000111000001
11000p0001110000000001
1h0000000000000C000011
1111000000011000000001
1E00000011100000000001
1g00000000001110000001
111000h000000000g00111
1000000000001100000001
1111111111111111111111