1111111111111111111111111111111111111111111111111111111111111111111111111111111111111111111111111111111111111111111111111111111111111111111111111111111111111111111111111
1ECCCCCCCCCCCCCCCCCCCCCCCCCCCCCCC0000000000000000000000000000000000000000X0000000000000C000000000000000000000000000000000000000000000000000000000000000000000000000000001
1C1CC1C1CC1CCCCC1C1CC1CCCCCCC1C1C0000000000000000000000000000000000000000000000000000000000000000000000000000000000000000000000000000000000000000000000000000000000000001
1C1CC1CC1C1C1C1CCC1CC1CCCCCCC1C1C0000000000000000000000000000000000000000000000C00000000000000000000000000000000000000000000000000000000000000000000000000000000000000001
1PCCCCCCCCCCCCCCCCCCCCCCCCCCCCCCC0000000000000000000000000000000000000000000000000000000000000000000000000000000000000000000000000000000000000000000000000000000000000001
1111111111111111111111111111111111111111111111111111111111111111111111111111111111111111111111111111111111111111111111111111111111111111111111111111111111111111111111111
