111111
1C0001
10P001
100001
111111
111111
1C0001
10P001
1000E1
111111
