1111111111111111111
1b000000000000000a1
1011011101011101101
1011011101011101101
1001C000C0C000C1001
1101010111110101011
10C0010001000100C01
1011111101011111101
10000CC0C0C0CC00001
1011100110110011101
101010010CP10010101
101E0C0111110C00101
1010100000000010101
1011100111110011101
10000CC00100CC00001
1011011101011101101
100100C00000C001001
1101010111110101011
10C0010001000100C01
1011111101011111101
1a000000C0C000000b1
1111111111111111111
