111111111111111111111111111111111111
1000000000000000001P0000100000000001
10000000000000000010h00010d000000d01
1011011101011101101a000g0000000000c1
1011011101011101101000h00e0000000001
1001C000C0C000C100000001000000000001
110101011111010101100000000000000001
10C0010001000100C01000000e0000000001
10111111010111111010000000000f110001
10000CC0C0C0CC0000100000011100000001
101110011011001110100000011110000001
101010010C010010101f00000000000000g1
101E0C0111110C0010100011000000000001
101010000000001010100001000000000001
101110011111001110100000100001000001
10000CC00100CC0000100001000010000001
101101110101110110100010100010100001
100100C0X000C00100100010000001010001
110101011111010101101100000011001001
10C0010001000100C0100000000111100001
1011111101011111101a00000000000000c1
10000000C0C0000000100b00000000000b01
111111111111111111111111111111111111