111111111111111111111111111111111111
1E10000000000C00000000000C0000000001
101010111011101011111010101010101001
1000000000001000000000000000C0000001
110010000000110000000000000000000001
101010101000110101011111100011101011
1000000011C1110000010000000000000011
1P0000001100000000000000000000000001
111111111111111111111111111111111111		